{
    "Tiles": [
        "###TTT################",
        "##TTTT##########TTTTT#",
        "#TTTT#########TTTTTTT#",
        "TTT############TTTTT##",
        "###############TTTT###",
        "#####~~~##############",
        "####~~~~~########TT###",
        "#####~~~~#############",
        "############~~~~######",
        "###########~~~~~~#####",
        "#########~~~~~~~~#####",
        "#######~~~~###~~~~####",
        "#######~~~~#T##~~~~###",
        "######~~~~~##T#~~~~###",
        "#######~~~~~##~~~#T###",
        "########~~~~~~~~~TT###",
        "#########~~~~~~~TT####",
        "######################",
        "###############T######",
        "###############TTTT###",
        "#################T####",
        "######################"
    ]
}